%%%%%%%%
%G     %
%      %
%      %
%     P%
%%%%%%%%
% %%%%%%
%%%%%%%%
