%%%%%%%%%
%      G%
%       %
%    G  %
%P      %
%%%%%%%%%
% % %%%%%
%%%%%%%%%
