%%%%%%%%%%%%
%         G%
%      %%%%%
%  G      .%
%P        G%
%%%%%%%%%%%%
% % % %%%%%%
%%%%%%%%%%%%
